########..###############
#.......##.#..#.#..#....#
.#.##................##.#
.#.#.#.#.#.#...###.#..#.#
.#.#...#.#.#.###.######.#
#..##.##.#.#.....#......#
#..##.#.#..############.#
.##.#.#.#........##.....#
#.#.###.##..###....#..###
#..........#..##.#.#.##.#
#...#..#..##......#..#..#
##.##.#.#.#.#.##.#.#.#.##
#..#..#...#.#.##.#.#....#
##.#..#..#..#.##.#...###.
#.#.#.#..#.##.##.######..
#.....#.##....##.......#.
########...#####.#####..#
#..#....###.............#
##...##.....#.##.######.#
#####..#####.#..#......##
